0000000000000000000000000000000000000000000000000000000000000
0000000000000000000002222200000000000000000000000000000000000
0002222000000000000000111000000000000000000000222200000000000
0000011000000000000000001000000222220000000000011120000000000
0000000000022222200000000000000011112000000000011112200000000
0000000000001111000000000000000000011000000000001000000000000
0000000000000010000000222000000000010000000000000000000000000
0002222200000000000000011000000000000000000000000022222200000
0001111000000000000000010000002200000000000000000211111000000
0000100000002222222000000000000000000000000000000111110000000
0000000000000111110000000000000000002000000220000011000000000
0000000000000000100000000022222222200000000112000000000000000
0000000000000000000002222211111111100000000000000000000000000
2220000000000000000000000000000000000000000000000000000000000
1112222220000000000000000000000000000000000222222200002222222
1111111112000022222222200000000000000000222111111000221111111
1111111111200001111111122222000000000002111111100000111111111
1111111111120000111111111111222222222221111111100002111111111
1111110000000000000000000000000000000000000000000011011111111
1111000000000010000000000000000000000000000000001000000000111
1000000011100000000000000111000000000000001110000000000000011
1100000000000000000000000000000000000000000000000000000111111
1111000000000011111110000000000000011100000000111111111111111
1111110000000000000000000000000000000000000000000000011111111
1111100000000000000000000000000000000000000000000000000011111
1111111110000001000000001111111000000000011000000011111111111
1111111111110000000000000000000000000000000000000111111111111
1111111111110000000000000000000000000000000000000111111111111
1111111111111111111111111111111111111111111111111111111111111
1111111111111111111111111111111111111111111111111111111111111
1111111111111111111111111111111111111111111111111111111111111
1111111111111111111111111111111111111111111111111111111111111
